{
	"level": 2,
	"name": "Caves",
	"terrain": [
		"###########################################################################",
		"#...............................................#.........................#",
		"#.................g.............................#.........................#",
		"#..............................................##.........................#",
		"#..........######..............................##.........................#",
		"#......g..########..............................##........................#",
		"#.........########...............................##.......................#",
		"#..........#######............#######..#..........##......................#",
		"#....#......######............#.....#..............#......................#",
		"#....##..............####.....#C....D.#.#..........#......................#",
		"#.....###..........###........##....#.............##......................#",
		"#....ggg###........#...........######..#..........#.......................#",
		"#######################...........................##......................#",
		"#...##....##..####.................................##.....................#",
		"#...#...............................................##....................#",
		"####..............................#########..........#....................#",
		"##........#....#.................##.......##.........#....................#",
		"##...##...#...##...g...##.......##.........#........##....................#",
		"#.........#...#........#........#..........#........##....................#",
		"#.......g.#.....................#....@....##D##......###..................#",
		"#..................#............#.........#...#........##.................#",
		"#..................##...........##........#...#.........##................#",
		"#...#........#.g....#....#.......##.......##..##.........#................#",
		"#...#.....###...........##........###......#...##.......##................#",
		"#...#........................##.....#......#....#......##.................#",
		"#...............####.........##......#.....#....###...##..................#",
		"#.....#.........#..#.................##....##.......###...................#",
		"#.....#.....#.............##......#...###...##.....##.....................#",
		"##.......g..#..............#.......................#......................#",
		"###........##..............#...##.#.......#........#......................#",
		"#.##.................##.............#....###......##......................#",
		"#..##..#..g......#...###................##.#......#.......................#",
		"#..#...#.........#..#...........##...####..########.......................#",
		"#..##..##..................###...#..##.......##...........................#",
		"#...#...##..##...........g.###......#.........#...........................#",
		"#...##..#...####.....#......#.......#.....................................#",
		"#....#..##..#......g.####...........#.....................................#",
		"#....##..##.............#...........#.....................................#",
		"#.....#...#...####..................#.....................................#",
		"#..########...#..##.................#.....................................#",
		"###########################################################################"
	],
	"mech": [
		"###########################################################################",
		"#...............................................#.........................#",
		"#.................g.............................#.........................#",
		"#..............................................##.........................#",
		"#..........######..............................##.........................#",
		"#......g..########..............................##........................#",
		"#.........########...............................##.......................#",
		"#..........#######............#######..#..........##......................#",
		"#....#......######............#.....#..............#......................#",
		"#....##..............####.....#C....L.#.#..........#......................#",
		"#.....###..........###........##....#.............##......................#",
		"#....ggg###........#...........######..#..........#.......................#",
		"#######################...........................##......................#",
		"#...##....##..####.................................##.....................#",
		"#...#...............................................##....................#",
		"####..............................#########..........#....................#",
		"##........#....#.................##.......##.........#....................#",
		"##...##...#...##...g...##.......##.........#........##....................#",
		"#.........#...#........#........#..........#........##....................#",
		"#.......g.#.....................#....@....##L##......###..................#",
		"#..................#............#.........#...#........##.................#",
		"#..................##...........##........#...#.........##................#",
		"#...#........#.g....#....#.......##.......##..##.........#................#",
		"#...#.....###...........##........###......#...##.......##................#",
		"#...#........................##.....#......#....#......##.................#",
		"#...............####.........##......#.....#....###...##..................#",
		"#.....#.........#..#.................##....##.......###...................#",
		"#.....#.....#.............##......#...###...##.....##.....................#",
		"##.......g..#..............#.......................#......................#",
		"###........##..............#...##.#.......#........#......................#",
		"#.##.................##.............#....###......##......................#",
		"#..##..#..g......#...###................##.#......#.......................#",
		"#..#...#.........#..#...........##...####..########.......................#",
		"#..##..##..................###...#..##.......##...........................#",
		"#...#...##..##...........g.###......#.........#...........................#",
		"#...##..#...####.....#......#.......#.....................................#",
		"#....#..##..#......g.####...........#.....................................#",
		"#....##..##.............#...........#.....................................#",
		"#.....#...#...####..................#.....................................#",
		"#..########...#..##.................#.....................................#",
		"###########################################################################"
	],
	"items": [
		"###########################################################################",
		"#...............................................#.........................#",
		"#.................g.............................#.........................#",
		"#..............................................##.........................#",
		"#..........######..............................##.........................#",
		"#......g..########..............................##........................#",
		"#.........########...............................##.......................#",
		"#..........#######............#######..#..........##......................#",
		"#....#......######............#.....#..............#......................#",
		"#....##..............####.....#C....D.#.#..........#......................#",
		"#.....###..........###........##....#.............##......................#",
		"#....ggg###........#...........######..#..........#.......................#",
		"#######################...........................##......................#",
		"#...##....##..####.................................##.....................#",
		"#...#...............................................##....................#",
		"####..............................#########..........#....................#",
		"##........#....#.................##.......##.........#....................#",
		"##...##...#...##...g...##.......##.........#........##....................#",
		"#.........#...#........#........#..........#........##....................#",
		"#.......g.#.....................#....@....##D##......###..................#",
		"#..................#............#.........#...#........##.................#",
		"#..................##...........##........#...#.........##................#",
		"#...#........#.g....#....#.......##.......##..##.........#................#",
		"#...#.....###...........##........###......#...##.......##................#",
		"#...#........................##.....#......#....#......##.................#",
		"#...............####.........##......#.....#....###...##..................#",
		"#.....#.........#..#.................##....##.......###...................#",
		"#.....#.....#.............##......#...###...##.....##.....................#",
		"##.......g..#..............#.......................#......................#",
		"###........##..............#...##.#.......#........#......................#",
		"#.##.................##.............#....###......##......................#",
		"#..##..#..g......#...###................##.#......#.......................#",
		"#..#...#.........#..#...........##...####..########.......................#",
		"#..##..##..................###...#..##.......##...........................#",
		"#...#...##..##...........g.###......#.........#...........................#",
		"#...##..#...####.....#......#.......#.....................................#",
		"#....#..##..#......g.####...........#.....................................#",
		"#....##..##.............#...........#.....................................#",
		"#.....#...#...####..................#.....................................#",
		"#..########...#..##.................#.....................................#",
		"###########################################################################"
	],
	"creatures": [
		"###########################################################################",
		"#...............................................#.........................#",
		"#.................g.............................#.........................#",
		"#..............................................##.........................#",
		"#..........######..............................##.........................#",
		"#......g..########..............................##........................#",
		"#.........########...............................##.......................#",
		"#..........#######............#######..#..........##......................#",
		"#....#......######............#.....#..............#......................#",
		"#....##..............####.....#C....D.#.#..........#......................#",
		"#.....###..........###........##....#.............##......................#",
		"#....ggg###........#...........######..#..........#.......................#",
		"#######################...........................##......................#",
		"#...##....##..####.................................##.....................#",
		"#...#...............................................##....................#",
		"####..............................#########..........#....................#",
		"##........#....#.................##.......##.........#....................#",
		"##...##...#...##...g...##.......##.........#........##....................#",
		"#.........#...#........#........#..........#........##....................#",
		"#.......g.#.....................#....@....##D##......###..................#",
		"#..................#............#.........#...#........##.................#",
		"#..................##...........##........#...#.........##................#",
		"#...#........#.g....#....#.......##.......##..##.........#................#",
		"#...#.....###...........##........###......#...##.......##................#",
		"#...#........................##.....#......#....#......##.................#",
		"#...............####.........##......#.....#....###...##..................#",
		"#.....#.........#..#.................##....##.......###...................#",
		"#.....#.....#.............##......#...###...##.....##.....................#",
		"##.......g..#..............#.......................#......................#",
		"###........##..............#...##.#.......#........#......................#",
		"#.##.................##.............#....###......##......................#",
		"#..##..#..g......#...###................##.#......#.......................#",
		"#..#...#.........#..#...........##...####..########.......................#",
		"#..##..##..................###...#..##.......##...........................#",
		"#...#...##..##...........g.###......#.........#...........................#",
		"#...##..#...####.....#......#.......#.....................................#",
		"#....#..##..#......g.####...........#.....................................#",
		"#....##..##.............#...........#.....................................#",
		"#.....#...#...####..................#.....................................#",
		"#..########...#..##.................#.....................................#",
		"###########################################################################"
	]
}
