{
	"level": 1,
	"name": "Dungeon",
	"terrain": [
		"###########################################################################",
		"#...D......##...##...##....##.....##..##...##........##..##..##...##......#",
		"#..##......##...##...##....##.....##..##........##...##......##...##......#",
		"#..##......##...D...###...........##..##...##...##...##..##..##...##......#",
		"#..##......D....###.###....##.######..##...##...##...##..##.......##......#",
		"#D#############D##...###.####.######.###...##...##...##..##...#...##......#",
		"#.#############.##...###.####.....##.#########.########..####.##########.##",
		"#....##....##...##...##....##.....##..########.#####....#####.##########.##",
		"#....##....##...##...##....###.#####.........#...##..##.###...#...##......#",
		"#....##....##...###.####.#####.#####..##.....##......##..##..##...##......#",
		"#....##....##...###.####.####.........##.........##..##..##..##...##......#",
		"#.....D....##...##...##....##.....##..##.....##..##..###.##..##...##......#",
		"##############.###...##....##.....##..##############.###.##.......##.######",
		"##############.###.........######.###.##############.##..##...#...##.######",
		"#..##...##......##...####.#######.###.##......##.....##..####.######......#",
		"#..##...........##...####.###.....##..##.............##..####.######......#",
		"#..##...##......##...##....##.....##..##......##.....##..##.......##......#",
		"#.......##......##.####....####.###########.###############..##...##......#",
		"############.#####.#####.######.###########.###############..#....#######.#",
		"############.#####...###.####.....##................##...#####.##....####.#",
		"#.......##......##...##....##.....##....##..##......##...#####.#####......#",
		"#...##..##......##...##....##.....##....##..##......##...##....#..##......#",
		"#...##..........####.##....##.....##....##..##...........##.......##......#",
		"######.#############.##....##.....##....##..##......#....##...##..##......#",
		"######.###########...#########.######################.##############......#",
		"#.........##....##...#########.######################.##############......#",
		"#....##.........##...##...........##................#...##........##.######",
		"#....##...##....##.####...##......##..##....##......##..##...##...##.######",
		"#....##...##....##.####...##......##..##....##..........##...##...##......#",
		"#######.##########...#########.#########.#############..########.###......#",
		"#######.##########...#########.#########.#############..########.###......#",
		"#.......#..##...##...##...........##.....##..##.....###.##...##...####.####",
		"#......##..##...##.####...##......##.........##.....###.##...##...####.####",
		"######.##..##...##.##########.######.....##..##.....##..###.###...##......#",
		"######.....####.##...########.######.....##..##.....##..###.###...##......#",
		"#......###.####.##...##...##......###.#####.....###.##..##...##.####......#",
		"#......###.##...####.##...........###.#####.#######.##.......##.#########.#",
		"#......##.......####.##...##......##.....##..##.....##.###...##...#######.#",
		"#......##..##...##...##...##......##.....##..##.....##..##........##......#",
		"#......##..##...##...##...##......##.....##..##.....##..##...##...##......#",
		"###########################################################################"
	],
	"mech": [
		"###########################################################################",
		"#...D......##...##...##....##.....##..##...##........##..##..##...##......#",
		"#..##......##...##...##....##.....##..##........##...##......##...##......#",
		"#..##......##...L...###...........##..##...##...##...##..##..##...##......#",
		"#..##......D....###.###....##.######..##...##...##...##..##.......##......#",
		"#D#############L###...###.####.######.###...##...##...##..##...#...##......#",
		"#.#############.##...###.####.....##.#########.########..####.##########.##",
		"#....##....##...##...##....##.....##..########.#####....#####.##########.##",
		"#....##....##...##...##....###.#####.........#...##..##.###...#...##......#",
		"#....##....##...###.####.#####.#####..##.....##......##..##..##...##......#",
		"#....##....##...###.####.####.........##.........##..##..##..##...##......#",
		"#.....D....##...##...##....##.....##..##.....##..##..###.##..##...##......#",
		"##############.###...##....##.....##..##############.###.##.......##.######",
		"##############.###.........######.###.##############.##..##...#...##.######",
		"#..##...##......##...####.#######.###.##......##.....##..####.######......#",
		"#..##...........##...####.###.....##..##.............##..####.######......#",
		"#..##...##......##...##....##.....##..##......##.....##..##.......##......#",
		"#.......##......##.####....####.###########.###############..##...##......#",
		"############.#####.#####.######.###########.###############..#....#######.#",
		"############.#####...###.####.....##................##...#####.##....####.#",
		"#.......##......##...##....##.....##....##..##......##...#####.#####......#",
		"#...##..##......##...##....##.....##....##..##......##...##....#..##......#",
		"#...##..........####.##....##.....##....##..##...........##.......##......#",
		"######.#############.##....##.....##....##..##......#....##...##..##......#",
		"######.###########...#########.######################.##############......#",
		"#.........##....##...#########.######################.##############......#",
		"#....##.........##...##...........##................#...##........##.######",
		"#....##...##....##.####...##......##..##....##......##..##...##...##.######",
		"#....##...##....##.####...##......##..##....##..........##...##...##......#",
		"#######.##########...#########.#########.#############..########.###......#",
		"#######.##########...#########.#########.#############..########.###......#",
		"#.......#..##...##...##...........##.....##..##.....###.##...##...####.####",
		"#......##..##...##.####...##......##.........##.....###.##...##...####.####",
		"######.##..##...##.##########.######.....##..##.....##..###.###...##......#",
		"######.....####.##...########.######.....##..##.....##..###.###...##......#",
		"#......###.####.##...##...##......###.#####.....###.##..##...##.####......#",
		"#......###.##...####.##...........###.#####.#######.##.......##.#########.#",
		"#......##.......####.##...##......##.....##..##.....##.###...##...#######.#",
		"#......##..##...##...##...##......##.....##..##.....##..##........##......#",
		"#......##..##...##...##...##......##.....##..##.....##..##...##...##......#",
		"###########################################################################"
			],
	"items": [
		"###########################################################################",
		"#...D......##...##...##....##.....##..##...##........##..##..##...##......#",
		"#..##......##...##...##....##.....##..##........##...##......##...##......#",
		"#..##......##...D...###...........##..##...##...##...##..##..##...##......#",
		"#..##......D....###.###....##.######..##...##...##...##..##.......##......#",
		"#D#############D##...###.####.######.###...##...##...##..##...#...##......#",
		"#.#############.##...###.####.....##.#########.########..####.##########.##",
		"#....##....##...##...##....##.....##..########.#####....#####.##########.##",
		"#....##....##...##...##....###.#####.........#...##..##.###...#...##......#",
		"#.W..##....##...###.####.#####.#####..##.....##......##..##..##...##......#",
		"#....##....##...###.####.####.........##.........##..##..##..##...##......#",
		"#.....D....##...##...##....##.....##..##.....##..##..###.##..##...##......#",
		"##############.###...##....##.....##..##############.###.##.......##.######",
		"##############.###.........######.###.##############.##..##...#...##.######",
		"#..##...##......##...####.#######.###.##......##.....##..####.######......#",
		"#..##...........##...####.###.....##..##.............##..####.######......#",
		"#..##...##......##...##....##.....##..##......##.....##..##.......##......#",
		"#.......##......##.####....####.###########.###############..##...##......#",
		"############.#####.#####.######.###########.###############..#....#######.#",
		"############.#####...###.####.....##................##...#####.##....####.#",
		"#.......##......##...##....##.....##....##..##......##...#####.#####......#",
		"#...##..##......##...##....##.....##....##..##......##...##....#..##......#",
		"#...##..........####.##....##.....##....##..##...........##.......##......#",
		"######.#############.##....##.....##....##..##......#....##...##..##......#",
		"######.###########...#########.######################.##############......#",
		"#.........##....##...#########.######################.##############......#",
		"#....##.........##...##...........##................#...##........##.######",
		"#....##...##....##.####...##......##..##....##......##..##...##...##.######",
		"#....##...##....##.####...##......##..##....##..........##...##...##......#",
		"#######.##########...#########.#########.#############..########.###......#",
		"#######.##########...#########.#########.#############..########.###......#",
		"#.......#..##...##...##...........##.....##..##.....###.##...##...####.####",
		"#......##..##...##.####...##......##.........##.....###.##...##...####.####",
		"######.##..##...##.##########.######.....##..##.....##..###.###...##......#",
		"######.....####.##...########.######.....##..##.....##..###.###...##......#",
		"#......###.####.##...##...##......###.#####.....###.##..##...##.####......#",
		"#......###.##...####.##...........###.#####.#######.##.......##.#########.#",
		"#......##.......####.##...##......##.....##..##.....##.###...##...#######.#",
		"#......##..##...##...##...##......##.....##..##.....##..##........##......#",
		"#......##..##...##...##...##......##.....##..##.....##..##...##...##......#",
		"###########################################################################"
			],
	"creatures": [
		"###########################################################################",
		"#...D......##...##...##....##.....##..##...##........##..##..##...##......#",
		"#.g##.g....##.g.##...##....##.....##..##........##...##......##...##......#",
		"#..##......##...D...###...........##..##...##...##...##..##..##...##......#",
		"#..##......D....###.###....##.######..##...##...##...##..##.......##......#",
		"#D#############D##...###.####.######.###...##...##...##..##...#...##......#",
		"#.#############.##...###.####.....##.#########.########..####.##########.##",
		"#....##..@.##...##...##....##.....##..########.#####....#####.##########.##",
		"#....##....##...##...##....###.#####.........#...##..##.###...#...##......#",
		"#....##....##...###.####.#####.#####..##.....##......##..##..##...##......#",
		"#....##....##...###.####.####.........##.........##..##..##..##...##......#",
		"#.....D....##...##...##....##.....##..##.....##..##..###.##..##...##......#",
		"##############.###...##....##.....##..##############.###.##.......##.######",
		"##############.###.........######.###.##############.##..##...#...##.######",
		"#..##...##......##...####.#######.###.##......##.....##..####.######......#",
		"#..##...........##...####.###.....##..##.............##..####.######......#",
		"#..##...##......##...##....##.....##..##......##.....##..##.......##......#",
		"#.......##......##.####....####.###########.###############..##...##......#",
		"############.#####.#####.######.###########.###############..#....#######.#",
		"############.#####...###.####.....##................##...#####.##....####.#",
		"#.......##......##...##....##.....##....##..##......##...#####.#####......#",
		"#...##..##......##...##....##.....##....##..##......##...##....#..##......#",
		"#...##..........####.##....##.....##....##..##...........##.......##......#",
		"######.#############.##....##.....##....##..##......#....##...##..##......#",
		"######.###########...#########.######################.##############......#",
		"#.........##....##...#########.######################.##############......#",
		"#....##.........##...##...........##................#...##........##.######",
		"#....##...##....##.####...##......##..##....##......##..##...##...##.######",
		"#....##...##....##.####...##......##..##....##..........##...##...##......#",
		"#######.##########...#########.#########.#############..########.###......#",
		"#######.##########...#########.#########.#############..########.###......#",
		"#.......#..##...##...##...........##.....##..##.....###.##...##...####.####",
		"#......##..##...##.####...##......##.........##.....###.##...##...####.####",
		"######.##..##...##.##########.######.....##..##.....##..###.###...##......#",
		"######.....####.##...########.######.....##..##.....##..###.###...##......#",
		"#......###.####.##...##...##......###.#####.....###.##..##...##.####......#",
		"#......###.##...####.##...........###.#####.#######.##.......##.#########.#",
		"#......##.......####.##...##......##.....##..##.....##.###...##...#######.#",
		"#......##..##...##...##...##......##.....##..##.....##..##........##......#",
		"#......##..##...##...##...##......##.....##..##.....##..##...##...##......#",
		"###########################################################################"
			]
}
