{
	"level": 1,
	"name": "Dungeon",
	"U": "previous_level.json",
	"B": "next_level.json",
	"terrain": [
		"##########",
		"#UB..#.C.#",
		"#....#...#",
		"#....D...#",
		"#....#...#",
		"##########"
	],
	"mech": [
		"##########",
		"#....#.L.#",
		"#....#...#",
		"#....L...#",
		"#....#...#",
		"##########"
	],
	"items": [
		"##########",
		"#....#...#",
		"#....#...#",
		"#W.......#",
		"#....#...#",
		"##########"
	],
	"creatures": [
		"##########",
		"#....#...#",
		"#@...#...#",
		"#......g.#",
		"#....#...#",
		"##########"
	]
}
