##########################################################################
#                  ##             ##           ##            ##          #
#                  ##                          ##            ##          #
#                  ##             ##           ##            ##          #
#                  ##             ##           ##            ##          #
#                  ##             ##           ##            ##          #
#                  ##             ##                                     #
#                  ##             ##           ##            ##          #
#                  ##             ##           ##            ##          #
#                                 ##           ##            ##          #
#                  ##             ##           ##            ##          #
#                  ##             ##           ##            ##          #
#                  ##             ##           ##            ##          #
#                  ##             ##           ##            ##          #
#                  ##             ##           ##            ##          #
#                  ##             ##           ##            ##          #
################################################################# ########
################################################################# ########
#                  ##           ##            ##              ##         #
#                  ##           ##            ##              ##         #
#                  ##           ##            ##              ##         #
#                  ##           ##            ##              ##         #
#                  ##           ##            ##              ##         #
#                  ##           ##            ##                         #
#                  ##                         ##              ##         #
#                  ##           ##            ##              ##         #
#                  ##           ##            ##              ##         #
#                  ##           ##            ##              ##         #
##### ################# ##########            ##              ##         #
##### ################# ############# #######    ######## ################
#                  ##           ##### ################### ################
#                  ##           ##            ##               ##        #
#                  ##           ##            ##               ##        #
#                  ##           ##            ##               ##        #
#                  ##           ##            ##                         #
#                               ##            ##               ##        #
#                  ##           ##            ##               ##        #
#                  ##           ##            ##               ##        #
#                  ##           ##            ##               ##        #
##########################################################################
