##########################################################################
#..................##.............##...........##............##..........#
#..................##..........................##............##..........#
#..................##.............##...........##............##..........#
#..................##.............##...........##............##..........#
#..................##.............##...........##............##..........#
#..................##.............##.....................................#
#..................##.............##...........##............##..........#
#..................##.............##...........##............##..........#
#.................................##...........##............##..........#
#..................##.............##...........##............##..........#
#..................##.............##...........##............##..........#
#..................##.............##...........##............##..........#
#..................##.............##...........##............##..........#
#..................##.............##...........##............##..........#
#..................##.............##...........##............##..........#
#################################################################.########
#################################################################.########
#..................##...........##............##..............##.........#
#..................##...........##............##..............##.........#
#..................##...........##............##..............##.........#
#..................##...........##............##..............##.........#
#..................##...........##............##..............##.........#
#..................##...........##............##.........................#
#..................##.........................##..............##.........#
#..................##...........##............##..............##.........#
#..................##...........##............##..............##.........#
#..................##...........##............##..............##.........#
#####.#################.##########............##..............##.........#
#####.#################.#############.#######....########.################
#..................##...........#####.###################.################
#..................##...........##............##...............##........#
#..................##...........##............##...............##........#
#..................##...........##............##...............##........#
#..................##...........##............##.........................#
#...............................##............##...............##........#
#..................##...........##............##...............##........#
#..................##...........##............##...............##........#
#..................##...........##............##...............##........#
##########################################################################
