###########################################################################
#..................##.............##.........##.........##................#
#..................##.............##.........##.........##................#
#..................##........................##.........##................#
#..................##.............##.........##.........##................#
#.................................##.........##.........##................#
#..................##.............##.........##.........##................#
#..................##.............##.........##.........##................#
#..................##.............##.........##.........##................#
#..................##.............##.........##.........##................#
#..................##.............##.........##.........##................#
#..................##.............##.........##.........##................#
#..................##.............##.........##.........##................#
#..................##.............##.........##.........##................#
######################.########################.........##................#
######################.########################...........................#
#..................##.............##.........##.........##................#
#..................##.............##.........#############.################
#..................##.............##.........#############.################
#..................##.............##.........##............##.............#
#..................##.............##.........##............##.............#
#..................##.............##.........##............##.............#
#..................##......................................##.............#
#..................##.............##.........##............##.............#
#..................##.............##.........##............##.............#
####.################.............##.........##............##.............#
####.##########################.###############............##.............#
#.....................#########.###############............##.............#
#..................##........##..............##...........................#
#..................##........##..............###################.##########
#..................##........................###################.##########
#..................##........##..............##............##.............#
#..................##........##..............##............##.............#
#..................##........##..............##...........................#
#..................##........##..............##............##.............#
#..................##........##..............##............##.............#
#..................##........##..............##............##.............#
#..................##........##..............##............##.............#
#..................##........##..............##............##.............#
#..................##........##..............##............##.............#
###########################################################################
